NO textures/horror/1.xpm
SO textures/horror/2.xpm
WE textures/horror/3.xpm
EA textures/horror/4.xpm

F 46, 37, 40
C 158, 14, 43

        1111111111111111111111
        1000000000010000000001
        101110000000000000W001
        1000100000110000000001
111111111011100000110000000001
1000000000110000000110011001111111
11110111111111011100000000000000011
111101111111110111010100100011110011
11000000110101011100000010001  11001
10000000000000000000000010001   1101
10000000000000001101010000001    101
11000001110101011111011110001   1101
11110111 1110101 101111010001  11001
11111111 1111111 1111111111011110011
                          100000011
                          11111111