NO ceux_qui_disent_pain_aux_chocolats
SO les_gens_bizarre_qui_disent_chocolatine
WE les_alcoolique_professionnel
EA les_bonnes_frites

F 25, 100,0
C 225,30,0

1111111111
1000000001
1000000001
1000000001
1010E00101
1000000001
1000000001
1000000001
1000000001
1111111111