NO ./textures/el_BG/bg_north.xpm
SO ./textures/el_BG/bg_south.xpm
WE ./textures/el_BG/bg_west.xpm
EA ./textures/el_BG/bg_east.xpm

F 0, 0, 1
C 216, 216, 200

1111111111111111111
1000000000000000001
1000000000000000001
1000100000000000001
1000S10000000000001
1000000000000000001
1000000000000000001
1000000000000000001
1000000000000000001
1111111111111111111