NO ceux_qui_disent_pain_aux_chocolats
SO les_gens_bizarre_qui_disent_chocolatine
WE les_alcoolique_professionnel
EA les_bonnes_frites

F 40, 80, 120
C 152, 152, 145

1111111111111111111
1000000000000000001
1000000000000000001
1000100000000000001
1000E10000000000001
1000000000000000001
1000000000000000001
1000000000000000001
1000000000000000001
1111111111111111111