NO ./textures/el_BG/bg_north.xpm
SO ./textures/el_BG/bg_south.xpm
WE ./textures/el_BG/bg_west.xpm
EA ./textures/el_BG/bg_east.xpm

F 128, 128, 128
C 0, 0, 0

1111111111111111111
1000000000000000001
1000000000000000001111
1111000100000000000001
1000N10000000000001111
1000000111000000001
10000001 1000000001
1000000111000000001
1000000000000000001
1111111111111111111
